###########################################################
#----------#----#---------#-------------------------------#
#-#####-####-####-#-#-----#-------------------------------#
#-------------#---#-#-----#-------------------------------#
#-------------#-#-#---##----------------------------------#
####-#-#-######-----#-----#-------------------------------#
#-------------------------#-------------------------------#
#####################-#########---------------------------#
#---------------------------------------------------------#
#---------------------------------------------------------#
#---------------------------------------------------------#
#---------------------------------------------------------#
#---------------------------------------------------------#
#---------------------------------------------------------#
#---------------------------------------------------------#
#---------------------------------------------------------#
#---------------------------------------------------------#
#---------------------------------------------------------#
#---------------------------------------------------------#
###########################################################
